11111111
10100001
10000001
11100001
10000001
10000111
11000001
10010111
100100$1
11111111