1111111111
1000100011
1010101011
1@10001001
1111111101
1000000001
1011111111
1000000111
1111110001
1000001101
1011100101
1$11110001
1111111111