111111111
100001111
101100111
1$1110001
111110101
111000101
111001111
111000001
111011111
111000001
111111111